S.IP..........PPI###############
I#########.#####################
.....P.........................A
.####.##.###.###################
P####.##.###.#####.....#########
.####.##.###.#####.###.##IIIIII#
P####.I..###.#####.###.##P....I#
.####P##P###.......###.##P######
P####.##.############.........A.
I####A...######################G
